---#--###----
-#---#----##-
####-#-#-#-##
---#---#-#---
-#-####---##-
-#------#-###
-############
-###########@
